"a" = (/turf,/area)
"b" = (/obj/wall/concrete/south,/turf,/area)
"c" = (/obj/wall/concrete/east,/obj/wall/concrete/south,/turf,/area)
"d" = (/turf/floor,/area)
"e" = (/obj/wall/concrete/south,/obj/wall/concrete/west,/turf,/area)
"f" = (/obj/wall/concrete/east,/turf,/area)
"g" = (/obj/wall/concrete/west,/turf/floor,/area)
"h" = (/obj/wall/concrete/west,/turf,/area)
"i" = (/obj/wall/concrete/north,/turf,/area)
"j" = (/obj/wall/concrete/north,/obj/wall/concrete/east,/turf,/area)
"k" = (/obj/wall/concrete/north,/obj/wall/concrete/west,/turf,/area)
"l" = (/obj/wall/concrete/south,/obj/wall/concrete/east,/turf,/area)
"m" = (/obj/wall/concrete/south,/turf/floor,/area)
"n" = (/obj/wall/concrete/east,/turf/floor,/area)
"o" = (/obj/wall/concrete/north,/obj/wall/concrete/west,/turf/floor,/area)
"p" = (/obj/wall/concrete/north,/turf/floor,/area)
"q" = (/obj/wall/concrete/east,/obj/wall/concrete/north,/turf/floor,/area)
"r" = (/obj/wall/concrete/south,/obj/wall/concrete/east,/turf/floor,/area)
"s" = (/obj/wall/concrete/south,/obj/wall/concrete/west,/turf/floor,/area)
"t" = (/obj/wall/concrete/west,/obj/wall/concrete/south,/turf/floor,/area)
"u" = (/obj/wall/concrete/north,/obj/wall/concrete/east,/turf/floor,/area)
"v" = (/obj/wall/concrete/west,/obj/wall/concrete/north,/turf/floor,/area)
"w" = (/obj/wall/concrete/east,/obj/wall/concrete/south,/turf/floor,/area)
"x" = (/obj/wall/concrete/east,/obj/wall/concrete/north,/turf,/area)
"y" = (/obj/wall/concrete/west,/obj/wall/concrete/north,/turf,/area)
"z" = (/obj/wall/concrete/west,/obj/wall/concrete/north,/obj/wall/concrete/south,/turf,/area)
"A" = (/obj/wall/concrete/west,/obj/wall/concrete/south,/turf,/area)
"B" = (/obj/wall/concrete/north,/obj/wall/concrete/south,/turf,/area)
"C" = (/obj/wall/concrete/north,/obj/wall/concrete/east,/obj/wall/concrete/south,/turf,/area)
"D" = (/obj/wall/concrete/south,/obj/wall/concrete/north,/obj/wall/concrete/east,/turf,/area)

(1,1,1) = {"
aaaaaaaaaaaaaaaaaaaaaaaaaaaaaaaaaaaaaaaaaaaaaaaaaaaaaaaaaaaa
aaaaaaaaaaaaaaaaaaaaaaaaaaaaaaaaaaaaaaaaaaaaaaaaaaaaaaaaaaaa
aaaaaaaaaaaaaaaaaaaaaaaaaaaaaaaaaaaaaaaaaaaaaaaaaaaaaaaaaaaa
aaaaaaaaaaaaaaaaaaaaaaaaaaaaaaaaaaaaaaaaaaaaaaaaaaaaaaaaaaaa
aaaaaaaaaaaaaaaaaaaaaaaaaaaaaaaaaaaaaaaaaaaaaaaaaaaaaaaaaaaa
aaaaaaaaaaaaaaaaaaaaaaaaaaaaaaaaaaaaaaaaaaaaaaaaaaaaaaaaaaaa
aaaaaaaaaaaaaaaaaaaaaaaaaaaaaaaaaaaaaaaaaaaaaaaaaaaaaaaaaaaa
aaaaaaaaaaaaaaaaaaaaaaaaaaaaaaaaaaaaaaaaaaaaaaaaaaaaaaaaaaaa
aaaaaaaaaaaaaaaaaaaaaaaaaaaaaaaaaaaaaaaaaaaaaaaaaaaaaaaaaaaa
aaaaaaaaaaaaaaaaaaaaaaaaaaaaaaaaaaaaaaaaaaaaaaaaaaaaaaaaaaaa
aaaaaaaaaaaaaaaaaaaaaaaaaaaaaaaaaaaaaaaaaaaaaaaaaaaaaaaaaaaa
aaaaaaaaaaaaaaaaaaaaaaaaaaaaaaaaaaaaaaaaaaaaaaaaaaaaaaaaaaaa
aaaaaaaaaaaaaaaaaaaaaaaaaaaaaaaaaaaaaaaaaaaaaaaaaaaaaaaaaaaa
aaaaaaaaaaaaaaaaaaaaaaaaaaaaaaaaaaaaaaaaaaaaaaaaaaaaaaaaaaaa
aaaaaaaaaaaaaaaaaaaaaaaaaaaaaaaaaaaaaaaaaaaaaaaaaaaaaaaaaaaa
aaaaaaaaaaaaaaaaaaaaaaaaaaaaaaaaaaabbcddddebbbbbbbbaaaaaaaaa
aaaaaaaaaaaaaaaaaaaaaaaaaaaaaaaaaafddddddddddgdddddhaaaaaaaa
aaaaaaaaaaaaaaaaaaaaaaaaaaaaaaaaaafddddddddddddddddhaaaaaaaa
aaaaaaaaaaaaaaaaaaaaaaaaaaaaaaaaaafddddddddddddddddhaaaaaaaa
aaaaaaaaaaaaaaaaaaaaaaaaaaaaaaaaaaaijddddddddddddddhaaaaaaaa
aaaaaaaaaaaaaaaaaaaaaaaaaaaaaaaaaaaafddddddddgdddddhaaaaaaaa
aaaaaaaaaaaaaaaaaaaaaaaaaaaaaaaaaaaafddddddddkiiiiiaaaaaaaaa
aaaaaaaaaaaaaaaaaaaaaaaaaaaaaaaaaaaafddddddddhaaaaaaaaaaaaaa
aaaaaaaaaaaaaaaaaaaaaaaaaaaaaaaaaaaaaiiiiiiiiaaaaaaaaaaaaaaa
aaaaaaaaaaaaaaaaaaaaaaaaaaaaaaaaaaaaaaaaaaaaaaaaaaaaaaaaaaaa
aaaaaaaaaaaaaaaaaaaaaaaaaaaaaaaaaaaaaaaaaaaaaaaaaaaaaaaaaaaa
aaaaaaaaaaaaaaaaaaaaaaaaaaaaaaaaaaaaaaaaaaaaaaaaaaaaaaaaaaaa
aaaaaaaaaaaaaaaaaaaaaaaaaaaaaaaaaaaaaaaaaaaaaaaaaaaaaaaaaaaa
aaaaaaaaaaaaaaaaaaaaaaaaaaaaaaaaaaaaaaaaaaaaaaaaaaaaaaaaaaaa
aaaaaaaaaaaaaaaaaaaaaaaaaaaaaaaaaaaaaaaaaaaaaaaaaaaaaaaaaaaa
aaaaaaaaaaaaaaaaaaaaaaaaaaaaaaaaaaaaaaaaaaaaaaaaaaaaaaaaaaaa
aaaaaaaaaaaaaaaaaaaaaaaaaaaaaaaaaaaaaaaaaaaaaaaaaaaaaaaaaaaa
aaaaaaaaaaaaaaaaaaaaaaaaaaaaaaaaaaaaaaaaaaaaaaaaaaaaaaaaaaaa
aaaaaaaaaaaaaaaaaaaaaaaaaaaaaaaaaaaaaaaaaaaaaaaaaaaaaaaaaaaa
aaaaaaaaaaaaaaaaaaaaaaaaaaaaaaaaaaaaaaaaaaaaaaaaaaaaaaaaaaaa
aaaaaaaaaaaaaaaaaaaaaaaaaaaaaaaaaaaaaaaaaaaaaaaaaaaaaaaaaaaa
aaaaaaaaaaaaaaaaaaaaaaaaaaaaaaaaaaaaaaaaaaaaaaaaaaaaaaaaaaaa
aaaaaaaaaaaaaaaaaaaaaaaaaaaaaaaaaaaaaaaaaaaaaaaaaaaaaaaaaaaa
aaaaaaaaaaaaaaaaaaaaaaaaaaaaaaaaaaaaaaaaaaaaaaaaaaaaaaaaaaaa
aaaaaaaaaaaaaaaaaaaaaaaaaaaaaaaaaaaaaaaaaaaaaaaaaaaaaaaaaaaa
aaaaaaaaaaaaaaaaaaaaaaaaaaaaaaaaaaaaaaaaaaaaaaaaaaaaaaaaaaaa
aaaaaaaaaaaaaaaaaaaaaaaaaaaaaaaaaaaaaaaaaaaaaaaaaaaaaaaaaaaa
aaaaaaaaaaaaaaaaaaaaaaaaaaaaaaaaaaaaaaaaaaaaaaaaaaaaaaaaaaaa
aaaaaaaaaaaaaaaaaaaaaaaaaaaaaaaaaaaaaaaaaaaaaaaaaaaaaaaaaaaa
aaaaaaaaaaaaaaaaaaaaaaaaaaaaaaaaaaaaaaaaaaaaaaaaaaaaaaaaaaaa
aaaaaaaaaaaaaaaaaaaaaaaaaaaaaaaaaaaaaaaaaaaaaaaaaaaaaaaaaaaa
aaaaaaaaaaaaaaaaaaaaaaaaaaaaaaaaaaaaaaaaaaaaaaaaaaaaaaaaaaaa
aaaaaaaaaaaaaaaaaaaaaaaaaaaaaaaaaaaaaaaaaaaaaaaaaaaaaaaaaaaa
aaaaaaaaaaaaaaaaaaaaaaaaaaaaaaaaaaaaaaaaaaaaaaaaaaaaaaaaaaaa
aaaaaaaaaaaaaaaaaaaaaaaaaabbbbbbbbbbbbbbbbbbbbaaaaaaaaaaaaaa
aaaaaaaaaaaaaaaaaaaaaaaaafddddddddddddgdddddddhaaaaaaaaaaaaa
aaaaaaaaaaaaaaaaaaaaaaaaafddddddddddddddddddddhaaaaaaaaaaaaa
aaaaaaaaaaaaaaaaaaaaaaaaafddddddddddddddddddddhaaaaaaaaaaaaa
aaaaaaaaaaaaaaaaaaaaaaaaafddddddddddddgdddddddhaaaaaaaaaaaaa
aaaaaaaaaaaaaaaaaaaaaaaaafddddddddddddgdddddddhaaaaaaaaaaaaa
aaaaaaaaaaaaaaaaaaaaaaaaafddddddddddddkiiiiiiiaaaaaaaaaaaaaa
aaaaaaaaaaaaaaaaaaaaaaaaafddddddddddddhaaaaaaaaaaaaaaaaaaaaa
aaaaaaaaaaaaaaaaaaaaaaaaafddddddddddddhaaaaaaaaaaaaaaaaaaaaa
aaaaaaaaaaaaaaaaaaaaaaaaalddddmmmmddddeaaaaaaaaaaaaaaaaaaaaa
aaaaaaaaaaaaaaaaaaaaaaaaaddddddddddddddaaaaaaaaaaaaaaaaaaaaa
"}

(1,1,2) = {"
dddddddddddddddddddddddddddddddddddddddddddddddddddddddddddd
ddmmmmmmmmmmmmmmmddddddddddddddddddddddddddddddddddddddddddd
dndddddddddddddddgdddddddddddddddddddddddddddddddddddddddddd
dndddddddddddddddgdddddddddddddddddddddddddddddddddddddddddd
dndddddddddddddddgdddddddddddddddddddddddddddddddddddddddddd
dndddddddddddddddgdddddddddddddddddddddddddddddddddddddddddd
dndddddddddddddddgdddddddddddddddddddddddddddddddddddddddddd
dndddddddddddddddgdddddddddddddddddddddddddddddddddddddddddd
dndddddddddddddddgdddddddddddddddddddddddddddddddddddddddddd
dndddddddddddddddgdddddddddddddddddddddddddddddddddddddddddd
dndddddddddddddddgdddddddddddddddddddddddddddddddddddddddddd
dndddddddddddddddgddddddddddopppppqddddddddddddddddddddddddd
dndddddddddddddddgddddddddddgdddddnddddddddddddddddddddddddd
dndddddddddddddddgddddddddddgdddddnddddddddddddddddddddddddd
dndddddddddddddddgddddddddddgdddddnddddddddddddddddddddddddd
dndddddddddddddddgddddddddddgdddddnmmraaaasmmmmmmmmddddddddd
dndddddddddddddddgddddddddddtmmdddnaaaaaaaaaahaaaadgdddddddd
dndddddddddddddddgdddddddddddddgddnaaaaaaaaaahaaaadgdddddddd
dndddddddddddddddtmmmmmmmmmmmmmsmdraaaaaaaaaahaaaadgdddddddd
dndddddddddddddddddddddddddddddddddddaaaaaaaahaaaadgdddddddd
dndddddddddddddddddddddddddddddddddddaaaaaaaahaaaddgdddddddd
dndddddddddddddddoppppppppppppupppuddaaaaaaaavpppddppudddddd
dndddddddddddddddgddddddddddddndddnddaaddaaaagdddddddndddddd
dndddddddddddddddgddddddddddddnddddddddddddddddddddddndddddd
ddpppppppppppppppdddddddddddddndddnddddddddddgdddddddndddddd
ddddddddddddddddddddddddddddddndddnddddddddddgdddddddndddddd
ddddddddddddddddddddddddddddddnddddpppuddoppptmmmmmmmwdddddd
ddddddddddddddddddddddddddddddndddddddnddgdddddddddddddddddd
ddddddddddddddddddddddddddddddndddddddnddgdddddddddddddddddd
ddddddddddddddddddddddddddddddnaaaaaaanddgdddddddddddddddddd
dddddddddddddddddddddddddddddddpppppppuddgdddddddddddddddddd
ddddddddddddddddddddddddddddddddddddddnddgdddddddddddddddddd
ddddddddddddddddddddddddddddddddddddddnddgdddddddddddddddddd
ddddddddddddddddddddddddddddddddddddddnddgdddddddddddddddddd
ddddddddddddddddddddddddddddddddddddddnddgdddddddddddddddddd
dddddddddddddddddddmmmddddddddddddddddnddgdddddddddddddddddd
ddddddddddddddddddndddgdddddddddddddddnddgdddddddddddddddddd
ddddddddddddddddddndddgdddddddddddddddnddgdddddddddddddddddd
ddddddddddddddddddndddgdddddddddddddddnddgdddddddddddddddddd
dddddddddddddddddddqdvddddddddddddddddnddgddmmmmmmmddddddddd
dddddddddddddddddddndgddddddddddddddddnddgdndddddddgdddddddd
dddddddddddddddddmmrdtddddddmmmmmmmmmmwddtmrdddddddgdddddddd
ddddddddddddddddwdddddgddddndddddndddddddddndddddddgdddddddd
ddddddddddddddddddddddsddddwdddddndddddddddndddddddgdddddddd
dddddddddddddddddddddddddddddddddddddddddddddddddddgdddddddd
dddddddddddddddddddddddddddddddddddddddddddddddddddgdddddddd
ddddddddddddddddddddddoddddudddddndddddddddndddddddgdddddddd
ddddddddddddddddudddddgddddndddddndddddddddndddddddgdddddddd
dddddddddddddddddudddodddddnddddddqddvpppppudddddddgdddddddd
ddddddddddddddddddddddddddmrmmmmmmwddtdddddndddddddgdddddddd
dddddddddddddddddddddddddnaaaaaaaaaaaagabbbapppppppddddddddd
dddddddddddddddddddddddddnaaaaaaaaaaaagfdddhdddddddddddddddd
dddddddddddddddddddddddddnaaaaaaaaaaaagaijahdddddddddddddddd
dddddddddddddddddddddddddnaaaaaaaaaaaagddaiadddddddddddddddd
dddddddddddddddddddddddddnaaaaaaaaaaaagddddddddddddddddddddd
dddddddddddddddddddddddddnaaaaaaaaaaaagddddddddddddddddddddd
dddddddddddddddddddddddddnaaaaaaaaaaaagddddddddddddddddddddd
dddddddddddddddddddddddddnaaaaaaaaaaaagddddddddddddddddddddd
dddddddddddddddddddddddddraaaabbbbaaaasddddddddddddddddddddd
dddddddddddddddddddddddddaaaaaaaaaaaaaaddddddddddddddddddddd
"}

(1,1,3) = {"
aaaaaaaaaaaaaaaaaaaaaaaaaaaaaaaaaaaaaaaaaaaaaaaaaaaaaaaaaaaa
aaaaaaaaaaaaaaaaaaaaaaaaaaaaaaaaaaaaaaaaaaaaaaaaaaaaaaaaaaaa
aaaaaaaaaaaaaaaaaaaaaaaaaaaaaaaaaaaaaaaaaaaaaaaaaaaaaaaaaaaa
aaaaaaaaaaaaaaaaaaaaaaaaaaaaaaaaaaaaaaaaaaaaaaaaaaaaaaaaaaaa
aaaaaaaaaaaaaaaaaaaaaaaaaaaaaaaaaaaaaaaaaaaaaaaaaaaaaaaaaaaa
aaaaaaaaaaaaaaaaaaaaaaaaaaaaaaaaaaaaaaaaaaaaaaaaaaaaaaaaaaaa
aaaaaaaaaabbaaaaaaaaaaaaaaaaaaaaaaaaaaaaaaaaaaaaaaaaaaaaaaaa
aaaaaaaaafadhaaaaaaaaaaaaaaaaaaaaaaaaaaaaaaaaaaaaaaaaaaaaaaa
aaaaaaaaaaxdhaaaaaaaaaaaaaaaaaaaaaaaaaaaaaaaaaaaaaaaaaaaaaaa
aaaaaaaaaafdhaaaaaaaaaaaaaaaaaaaaaaaaaaaaaaaaaaaaaaaaaaaaaaa
aaaaaaaaaafdhaaaaaaaaaaaaaaaaaaaaaaaaaaaaaaaaaaaaaaaaaaaaaaa
aaaaaaaaaafdhaaaaaaaaaaaaaaaaaaaaaaaaaaaaaaaaaaaaaaaaaaaaaaa
aaaaaaaaaafdhaaaaaaaaaaaaaaaaaabbaaaaaaaaaaaaaaaaaaaaaaaaaaa
aaaaaaaaaafdhaaaaaaaaaaaaaaaaafadhaaaaaaaaaaaaaaaaaaaaaaaaaa
aaaaaaaaaafdhaaaaaaaaaaaaaaaaaajdhaaaaaaaaaaaaaaaaaaaaaaaaaa
aaaaaaaaaafdhaaaaaaaaaaaaaaaaaafdhaaaaaaaaaaaaaaaaaaaaaaaaaa
aaaaaaabaafdhaaaaaaaaaaaaaaaaaafdhaaaaabaaaaaaaaaaaaaaaaaaaa
aaaaaafahafdhaaaaaaaaaaaaaaaaaafdhaaaafahaaaaaabbbaaaaaaaaaa
aaaaaafdebldebbbbbbbbbbbbbbbbbbcdebbbbcdhaaaaafaddhaaaaaaaaa
aaaaaafdddddddddddddddddddddddddddddddddhaaaaaaijdhaaaaaaaaa
aaaaaaaiiiiiiiiiiiiiiiiiiiiiiiiiiiiiiixdhaaaaaaafdhaaaaaaaaa
aaaaaaaaaaaaaaaaaaaaaaaaaaaaaaaaaaaaaafdhaaaaaaafdhaaaaaaaaa
aaaaaaaaaaaaaaaaaaaaaaaaaaaaaaaaaaaaaafdebbbbbbbldhaaaaaaaaa
aaaaaaaaaaaaaaaaaaaaaaaaaaaaaaaabbbbbbldddddddddddhaaaaaaaaa
aaaaaaaaaaaaaaaaaaaaaaaaaaaaaaafddddddddyiiiiijdziaaaaaaaaaa
aaaaaaaaaaaaaaaaaaaaaaaaaaaaaaafdyiiiixdhaaaaafdahaaaaaaaaaa
aaaaaaaaaaaaaaaaaaaaaaaaaaaaaaafdhaaaafdhaaaaaaiiaaaaaaaaaaa
aaaaaaaaaaaaaaaaaaaaaaaaaaaaaaafahaaaafdhaaaaaaaaaaaaaaaaaaa
aaaaaaaaaaaaaaaaaaaaaaaaaaaaaaaaiaaaaafdhaaaaaaaaaaaaaaaaaaa
aaaaaaaaaaaaaaaaaaaaaaaaaaaaaaaaaaaaaafdhaaaaaaaaaaaaaaaaaaa
aaaaaaaaaaaaaaaaaaaaaaaaaaaaaaaaaaaaaafdhaaaaaaaaaaaaaaaaaaa
aaaaaaaaaaaaaaaaaaaaaaaaaaaaaaaaaaaaaafdhaaaaaaaaaaaaaaaaaaa
aaaaaaaaaaaaaaaaaaaaaaaaaaaaaaaaaaaaaafdhaaaaaaaaaaaaaaaaaaa
aaaaaaaaaaaaaaaaaaaaaaaaaaaaaaaaaaaaaafdhaaaaaaaaaaaaaaaaaaa
aaaaaaaaaaaaaaaaaaaaaaaaaaaaaaaaaaaaaafdhaaaaaaaaaaaaaaaaaaa
aaaaaaaaaaaaaaaaaaaaaaaaaaaaaaaaaaaaaafdhaaaaaaaaaaaaaaaaaaa
aaaaaaaaaaaaaaaaaaaaaaaaaaaaaaaaaaaaaafdhaaaaaaaaaaaaaaaaaaa
aaaaaaaaaaaaaaaaaaaaaaaaaaaaaaaaaaaaaafdhaaaaaaaaaaaaaaaaaaa
aaaaaaaaaaaaaaaaaaaaaaaaaaaaaaaaaaaaaafdhaaaaaaaaaaaaaaaaaaa
aaaaaaaaaaaaaaaaaaaaaaaaaaaaaaaaaaaaaafdhaaaaaaaaaaaaaaaaaaa
aaaaaaaaaaaaaaaaaaaaaaaaaaaaaaaaaaaaaafdhaaaaaaaaaaaaaaaaaaa
aaaaaaaaaaaaaaaaaaaaaaaaaaaaaaaaaaaaaafdhaaaaaaaaaaaaaaaaaaa
aaaaaaaaaaaaaaaaaaaaaaaaaaaaabbbaaaaaafdAbbbbbbbaaaaaaaaaaaa
aaaaaaaaaaaaaaaaaaabaaaaaaaafaddebbbbbldddddddddhaaaaaaaaaaa
aaaaaaaaaaaaaaaaaafaebbbbbbbbBCdddddddddyiiiiixdhaaaaaaaaaaa
aaaaaaaaaaaaaaaaaafdddddddddddddkixdyijdeaaaaafahaaaaaaaaaaa
aaaaaaaaaaaaaaaaaaaiiiiiiiiiiiiiaafdhafdahaaaaaiaaaaaaaaaaaa
aaaaaaaaaaaaaaaaaaaaaaaaaaaaaaaaaafdhaaiiaaaaaaaaaaaaaaaaaaa
aaaaaaaaaaaaaaaaaaaaaaaaaaaaaaaaaafdhaaaaaaaaaaaaaaaaaaaaaaa
aaaaaaaaaaaaaaaaaaaaaaaaaaaaaaaaaafdhaaaaaaaaaaaaaaaaaaaaaaa
aaaaaaaaaaaaaaaaaaaaaaaaaaaabaaaaafdebbbbaaaaaaaaaaaaaaaaaaa
aaaaaaaaaaaaaaaaaaaaaaaaaaafahaaaafdddddahaaaaaaaaaaaaaaaaaa
aaaaaaaaaaaaaaaaaaaaaaaaaaafdebbbbldkiiiiaaaaaaaaaaaaaaaaaaa
aaaaaaaaaaaaaaaaaaaaaaaaaaafddddddddhaaaaaaaaaaaaaaaaaaaaaaa
aaaaaaaaaaaaaaaaaaaaaaaaaaaaiiiiiDdkaaaaaaaaaaaaaaaaaaaaaaaa
aaaaaaaaaaaaaaaaaaaaaaaaaaaaaaaafadhaaaaaaaaaaaaaaaaaaaaaaaa
aaaaaaaaaaaaaaaaaaaaaaaaaaaaaaaaaiiaaaaaaaaaaaaaaaaaaaaaaaaa
aaaaaaaaaaaaaaaaaaaaaaaaaaaaaaaaaaaaaaaaaaaaaaaaaaaaaaaaaaaa
aaaaaaaaaaaaaaaaaaaaaaaaaaaaaaaaaaaaaaaaaaaaaaaaaaaaaaaaaaaa
aaaaaaaaaaaaaaaaaaaaaaaaaaaaaaaaaaaaaaaaaaaaaaaaaaaaaaaaaaaa
"}
